wwwwwwwwwwwww
wg----w----gw
w--g--w-----w
w--g-----g--w
w-----w-----w
w-----w--g--w
ww-wwww-----w
w-----www-www
w---a-w-----w
w-a---w--g--w
w--a--------w
w-g---w-----w
wwwwwwwwwwwww